5
200E1020-0
-00---3002
00100----0
2---1-2010
00-00-2-00
-000-0000-
20001020-0
-00---3002
00100----0
2---1-2010
00-00-2-00
-000T0000-